36 
300 300 300 200 300 300 300 300 300 300 300 300 300 101 101 101 101 101 101 101 101 101 101 101 101 300 101 101 101 101 101 101 101 101 101 101 101 
300 101 101 200 101 101 101 101 101 101 101 101 101 101 101 101 101 101 101 101 101 101 101 101 101 300 101 101 101 101 101 101 300 101 101 101 101 
300 101 101 200 101 101 101 101 101 101 101 101 101 101 101 101 101 101 101 101 101 101 101 101 101 300 101 101 300 101 101 101 300 101 101 101 101 
300 101 101 101 101 101 101 101 101 101 101 101 101 101 101 101 101 101 101 101 101 101 101 101 101 300 101 101 300 101 101 101 300 101 101 101 101 
300 101 101 101 101 101 101 101 101 101 101 101 101 101 101 101 101 101 101 101 101 101 101 101 101 300 101 300 300 101 101 101 300 101 101 101 101 
300 101 101 101 101 101 101 101 101 101 101 101 101 101 101 101 101 101 101 101 101 101 101 300 101 300 101 300 300 101 101 101 300 101 101 101 101 
300 101 101 101 101 101 101 101 101 101 101 101 101 101 101 101 101 101 101 101 101 101 101 300 101 300 101 300 300 101 101 101 101 101 101 101 101 
300 101 101 101 101 101 101 101 101 101 101 101 101 101 101 101 101 101 101 101 101 101 101 300 101 300 101 300 101 101 101 300 300 300 101 101 101 
300 101 101 101 101 101 101 101 101 101 101 101 101 101 101 101 101 101 101 101 101 101 300 300 101 300 101 300 300 101 101 101 101 300 101 101 101 
300 101 101 101 101 101 101 101 101 101 101 101 101 101 101 101 101 101 101 101 101 101 300 300 101 300 101 300 101 300 101 101 101 300 101 101 101 
300 101 101 101 101 101 101 101 101 101 101 101 101 101 101 101 101 101 101 101 101 101 300 300 101 300 101 300 101 300 101 101 101 300 101 101 101 
300 101 101 101 101 101 101 101 101 101 101 101 101 101 101 101 101 101 101 101 101 101 300 300 101 300 101 300 101 300 101 101 101 300 101 101 101 
300 101 101 101 101 101 101 101 101 101 101 101 101 101 101 101 101 101 101 101 101 101 300 300 101 300 101 300 101 300 101 101 101 300 101 101 101 
300 101 101 101 101 101 101 101 101 101 101 101 101 101 101 101 101 101 101 101 101 101 300 300 101 300 101 300 101 300 101 101 101 300 101 101 101 
300 101 101 101 101 101 101 101 101 101 101 101 101 101 101 101 101 101 101 101 101 101 300 300 101 300 101 300 101 300 101 101 101 300 101 101 101 
300 101 101 101 101 101 101 101 101 101 101 101 101 101 101 101 101 101 101 101 101 101 300 300 101 300 101 300 101 300 101 101 101 300 101 101 101 
300 101 101 101 101 101 101 101 101 101 101 101 101 101 101 101 101 101 101 101 101 101 300 300 101 300 101 300 101 300 101 101 101 300 101 101 101 
300 101 101 101 101 101 101 101 101 101 101 101 101 101 101 101 300 101 101 101 300 300 300 300 101 300 101 300 101 300 101 101 101 300 101 101 101 
300 101 101 101 101 101 300 300 300 300 300 300 300 300 300 300 300 300 300 300 300 300 300 300 300 300 300 300 300 300 300 300 101 300 101 300 101 
300 101 101 101 101 101 300 101 101 101 101 101 101 101 101 101 300 101 101 101 101 101 300 300 101 300 101 300 101 300 101 101 101 300 101 300 101 
300 101 101 101 101 101 300 101 101 101 101 101 101 101 101 101 300 101 101 101 101 101 300 300 101 300 101 300 101 300 101 101 101 300 101 300 101 
300 101 101 101 101 101 300 101 101 101 101 300 101 101 101 101 300 101 101 101 101 101 300 300 101 300 101 300 101 300 101 101 101 300 101 300 101 
300 101 101 300 101 101 300 101 101 101 101 300 101 101 101 101 300 101 101 101 300 300 300 300 300 300 300 300 300 300 300 300 300 300 101 300 101 
300 101 101 300 101 101 300 101 101 101 101 300 101 101 101 101 300 101 101 101 300 101 300 300 101 300 101 101 101 300 101 101 300 300 101 300 101 
300 101 101 300 300 300 300 300 300 300 300 300 300 300 300 300 300 300 300 300 300 300 300 300 300 300 300 300 101 300 101 101 300 300 101 300 101 
300 101 101 300 101 101 300 101 300 101 101 300 101 101 101 101 300 101 101 101 300 101 300 300 101 300 101 101 101 300 101 101 300 300 101 300 101 
300 101 101 300 101 101 300 101 300 101 101 300 101 101 101 101 300 101 101 101 300 101 300 300 101 300 101 101 101 300 101 101 300 300 101 300 101 
300 300 300 300 300 300 300 300 300 101 101 300 101 101 101 101 300 101 101 101 300 101 101 300 101 300 101 101 101 300 101 101 300 101 101 101 101 
300 101 300 300 300 300 300 300 300 300 300 300 300 300 300 300 300 300 300 300 300 300 300 300 300 300 300 300 300 300 300 300 300 300 300 300 101 
300 101 300 300 300 300 300 300 300 300 300 300 300 300 300 300 300 300 300 300 300 300 300 300 300 300 300 300 300 300 300 300 300 101 101 101 101 
300 101 101 300 101 300 300 101 101 101 101 300 101 101 101 101 300 101 101 101 101 101 101 300 101 300 101 101 101 300 101 101 101 101 101 101 101 
300 101 101 300 101 300 300 101 101 101 101 300 101 101 101 101 300 101 101 101 101 101 101 300 101 101 101 101 101 300 101 101 101 101 101 101 101 
300 101 101 300 101 300 300 101 101 101 101 300 101 101 101 101 101 101 101 101 101 101 300 300 300 300 101 101 101 300 101 101 101 101 101 101 101 
101 101 101 300 101 300 300 101 101 101 101 300 101 300 300 300 300 300 300 300 300 300 300 300 101 101 101 101 101 300 101 101 101 101 101 101 101 
101 101 101 101 101 101 300 101 101 101 101 101 101 101 101 101 101 101 101 101 101 101 101 101 101 101 101 101 101 101 101 101 101 101 101 101 101 
300 300 300 300 300 300 300 300 300 300 300 300 300 300 300 300 300 300 300 300 300 300 300 300 300 300 300 300 300 300 101 101 101 101 101 101 101 
101 101 101 101 101 101 101 101 101 101 101 101 101 101 101 101 101 101 101 101 101 101 101 101 101 101 101 101 101 101 101 101 101 101 101 101 101 